50 100
3 56 56 56 56 56 56 56 56 56 56 56 56 56 29 29 29 29 29 29 29 29 29 29 38 38 38 38 38 38 88 88 88 88 88 88 88 88 54 54 89 89 89 89 89 14 14 14 79 79
3 56 56 56 56 56 56 56 56 56 56 56 56 29 29 29 29 29 29 29 29 29 29 29 38 38 38 38 2 2 88 88 88 88 88 88 88 88 88 54 54 89 89 14 14 14 14 14 14 79
3 3 3 3 56 56 56 56 56 56 56 56 56 29 29 29 29 29 29 29 29 29 29 29 94 38 38 38 2 2 88 88 88 88 88 88 88 88 88 54 54 14 14 14 14 14 14 14 14 14
95 3 3 46 46 46 46 46 56 56 56 56 29 29 29 29 29 29 29 94 94 29 94 94 94 38 38 38 2 2 2 2 2 88 88 88 88 88 88 54 54 14 14 14 14 14 14 14 14 14
95 3 3 46 46 46 46 46 56 56 56 56 29 29 29 29 29 29 94 94 94 94 94 94 94 38 96 96 96 2 2 2 2 2 88 88 88 54 54 54 14 14 14 14 14 14 14 67 67 67
95 95 3 46 46 46 46 46 46 46 46 29 29 29 29 29 29 29 94 94 94 94 94 94 94 96 96 96 2 2 2 2 2 2 98 88 88 54 54 14 14 14 14 14 14 14 67 67 67 67
95 95 46 46 46 46 9 9 46 46 46 46 46 29 29 29 29 94 94 94 94 94 96 96 96 96 96 2 2 2 2 2 2 98 98 98 98 98 14 14 14 14 14 14 14 67 67 67 67 67
95 95 46 9 9 46 9 9 46 46 46 46 29 29 29 29 94 94 94 94 94 96 96 96 96 96 98 2 2 2 2 2 2 98 98 98 98 98 98 14 14 14 14 14 14 67 67 67 67 67
95 9 9 9 9 9 9 9 9 46 46 46 29 29 29 29 29 94 94 94 96 96 96 96 96 96 98 98 98 98 98 98 2 98 98 98 98 98 98 14 14 14 14 14 14 14 67 67 67 67
66 9 9 9 9 9 9 87 9 46 46 46 46 29 29 29 29 94 96 96 96 96 96 96 96 96 52 98 98 86 98 98 98 98 98 98 98 98 98 16 16 16 14 67 67 67 67 67 67 67
66 9 9 9 9 9 87 87 87 87 87 87 87 87 29 29 49 49 96 96 96 96 96 96 96 96 52 52 86 86 86 98 98 69 69 16 16 16 16 16 16 16 14 67 67 67 67 67 67 67
66 66 9 9 87 87 87 87 87 87 87 87 87 87 49 29 49 49 96 96 96 96 96 52 52 52 52 52 86 86 69 69 69 69 69 16 16 16 16 16 34 34 34 67 67 67 67 67 67 67
66 66 9 9 9 50 87 87 87 87 87 87 49 49 49 49 49 49 49 49 49 52 52 52 52 52 52 52 52 52 13 13 69 69 11 11 16 16 16 16 34 34 34 34 67 67 67 34 67 67
66 37 50 50 50 50 50 87 87 87 87 97 97 97 97 97 49 49 49 49 49 49 52 52 52 52 52 52 63 63 63 69 69 11 11 11 16 48 16 16 34 34 34 34 34 34 34 34 34 67
37 37 37 50 37 50 50 87 87 87 87 97 97 97 97 97 49 49 49 49 49 49 52 52 52 52 52 52 63 63 63 63 63 11 11 92 16 48 92 34 34 34 34 34 34 34 34 34 34 67
37 37 37 37 37 50 87 87 87 87 87 97 97 97 97 49 49 49 49 49 49 49 49 49 52 52 52 52 63 63 63 63 63 10 11 92 92 92 92 34 34 34 34 34 34 34 34 34 34 90
37 37 37 37 37 37 37 37 37 37 37 97 97 97 97 97 49 49 49 23 23 23 23 52 52 52 52 52 63 63 63 63 63 10 92 92 92 92 92 34 34 34 34 34 34 34 90 90 90 90
37 37 37 37 37 37 37 37 37 37 97 97 97 97 97 97 28 49 49 23 23 23 23 23 23 23 52 52 63 63 63 10 10 10 10 92 92 92 92 32 34 34 34 34 34 34 90 90 90 90
25 37 37 37 37 37 37 37 37 37 37 97 97 97 97 97 28 28 28 23 23 23 23 23 23 23 52 52 70 70 70 10 10 10 10 10 32 32 32 32 34 45 64 64 64 64 90 90 90 90
25 37 37 37 37 37 37 37 37 37 73 97 97 97 97 97 44 28 28 28 28 28 6 23 6 23 6 6 70 70 5 10 10 10 74 74 74 32 32 32 45 45 64 45 64 64 90 90 90 90
37 37 37 37 37 37 37 37 37 73 73 73 73 73 73 44 44 28 28 28 28 28 6 6 6 6 6 6 6 5 5 5 5 5 74 74 74 74 45 45 45 45 45 45 64 64 90 90 90 90
37 37 37 37 37 37 33 33 37 73 73 73 73 73 44 44 44 44 28 28 28 6 6 6 6 6 6 6 5 5 5 5 5 5 74 74 74 45 45 45 45 45 76 76 90 90 90 90 90 53
37 37 33 33 33 33 33 33 33 33 73 73 73 44 44 44 44 28 28 28 28 17 17 6 6 6 6 6 6 5 5 5 5 5 74 74 74 35 35 35 76 76 76 76 90 90 90 90 53 53
59 59 59 33 33 33 33 33 33 33 33 33 73 73 44 44 44 28 28 28 28 17 17 6 6 6 6 6 6 5 5 5 5 60 60 60 35 35 35 76 76 76 76 76 90 90 90 90 53 53
59 59 33 33 33 33 33 33 33 33 33 72 44 44 44 44 44 28 28 17 17 17 17 17 6 6 6 6 5 5 5 5 60 60 60 35 35 35 35 76 47 76 76 90 90 90 71 71 53 53
59 59 59 33 33 33 33 33 33 33 72 72 72 72 44 44 44 44 28 17 17 17 17 17 6 6 6 6 5 5 5 5 60 60 60 60 47 35 35 47 47 76 90 90 90 71 71 71 71 20
59 59 59 33 33 33 33 33 33 33 72 72 72 72 65 65 4 4 4 4 17 17 17 43 43 6 1 1 1 1 1 60 60 60 60 60 47 47 47 47 47 82 82 82 82 82 71 71 71 20
59 59 59 33 33 33 33 33 33 33 72 72 72 65 65 4 4 4 4 17 17 17 17 43 43 6 1 1 1 1 1 60 60 60 47 47 47 47 47 47 47 82 82 82 82 82 82 82 71 20
59 59 59 33 33 33 33 33 33 68 68 72 72 65 65 65 4 4 4 4 17 17 17 17 17 17 57 1 1 1 1 15 60 15 47 47 47 47 47 18 18 18 82 82 82 82 82 82 20 20
59 59 59 59 33 33 33 33 33 68 68 68 72 65 65 65 65 84 84 84 84 31 17 17 17 57 57 57 1 1 1 15 15 15 15 15 47 47 47 18 18 18 82 82 82 82 82 82 20 27
59 59 59 59 33 33 33 33 68 68 68 68 65 65 65 65 65 30 84 84 84 31 31 31 31 57 57 55 1 1 1 1 1 15 15 47 47 47 36 36 18 18 82 82 82 82 82 82 27 27
59 59 59 59 75 33 33 33 33 99 99 99 99 99 65 65 30 30 84 84 84 84 31 31 31 31 12 12 1 1 1 1 1 15 15 47 41 47 36 36 18 18 82 82 82 82 78 78 78 27
59 75 59 59 75 75 33 33 99 99 99 99 99 99 99 99 99 30 30 84 84 84 31 40 40 40 40 12 1 1 1 1 1 1 1 47 41 41 41 36 85 85 85 85 78 78 78 78 78 27
75 75 75 75 75 75 75 75 75 80 80 99 99 99 99 30 30 30 30 30 84 84 93 93 93 40 40 40 40 1 1 1 1 1 1 47 41 41 41 36 85 85 85 85 78 78 78 78 78 27
75 75 75 75 75 75 75 75 75 80 80 61 99 99 99 99 99 30 30 30 30 30 93 93 93 93 93 42 42 42 42 42 42 1 1 41 41 41 41 41 85 85 85 85 85 78 78 78 78 27
75 75 75 75 75 75 75 80 80 80 80 61 99 99 99 99 99 30 30 30 30 30 93 93 93 42 42 42 42 42 42 42 42 22 22 22 22 41 41 41 85 85 85 85 85 78 78 78 27 27
75 75 75 75 75 75 75 80 80 80 80 61 99 99 99 99 99 30 30 30 30 30 42 42 42 42 42 42 42 42 51 42 22 22 22 22 22 22 41 41 41 85 85 85 85 78 78 78 78 78
75 75 75 75 75 75 75 80 80 80 80 61 61 61 61 26 99 30 30 30 30 30 42 42 42 42 42 42 42 42 51 51 22 22 22 22 22 22 22 22 22 85 85 85 85 85 78 78 78 78
75 75 75 75 75 75 75 7 80 80 80 61 61 61 61 26 26 26 26 30 30 26 26 26 42 42 42 42 42 42 51 51 51 22 22 22 22 22 22 22 22 22 22 85 85 85 85 21 21 21
75 75 75 75 75 75 75 7 7 80 80 61 61 61 61 26 26 26 26 26 26 26 26 26 26 42 42 42 51 51 51 51 51 19 19 22 22 22 22 22 22 22 22 22 22 58 85 21 21 21
75 75 75 75 75 75 75 75 80 80 80 80 61 61 26 26 26 26 26 26 26 26 26 26 26 42 42 42 51 51 51 51 19 19 19 19 22 22 22 22 22 22 22 22 22 58 21 21 21 21
75 75 75 75 75 75 75 75 80 80 80 80 80 26 26 26 26 39 83 83 26 26 26 26 26 26 42 42 51 51 51 19 19 19 19 22 22 22 22 22 22 22 58 58 58 58 21 21 21 81
75 75 75 24 24 75 24 24 80 80 80 80 80 26 26 26 26 39 83 83 26 26 26 26 26 77 42 42 51 51 51 51 19 19 19 22 22 22 22 22 22 22 58 58 58 58 21 21 21 81
75 75 75 24 24 24 24 24 24 91 91 91 91 91 26 26 26 26 83 83 83 77 77 77 26 77 42 51 51 51 51 51 19 19 19 100 100 22 22 22 22 58 58 58 58 58 21 21 21 81
8 24 24 24 24 24 24 24 24 91 91 91 91 91 91 91 26 26 83 83 83 77 77 77 77 77 77 77 77 51 51 51 19 19 19 100 100 100 22 22 58 58 58 58 58 58 21 21 81 81
8 24 24 24 24 24 24 24 24 24 91 91 91 91 91 91 91 91 83 83 77 77 77 77 77 77 77 77 77 51 51 51 19 19 19 100 100 100 22 22 58 58 58 58 58 58 58 62 81 81
8 8 8 8 24 24 24 24 24 24 91 91 91 91 91 91 91 91 83 83 77 77 77 77 77 77 77 77 77 51 19 19 19 19 19 100 22 22 22 22 22 22 62 58 58 58 62 62 62 81
8 8 8 8 8 24 24 24 24 24 91 91 91 91 91 91 91 91 83 83 77 77 77 77 77 77 77 77 77 77 19 19 19 19 19 19 22 22 22 22 62 62 62 62 62 62 62 62 62 62
8 8 8 8 8 24 24 24 24 24 24 91 91 91 91 91 91 77 77 83 77 77 77 77 77 77 77 77 77 77 19 19 19 19 19 22 22 22 22 22 22 62 62 62 62 62 62 62 62 62
8 8 8 8 8 24 24 24 24 24 24 91 91 91 91 91 91 77 77 77 77 77 77 77 77 77 77 77 77 77 19 19 19 19 22 22 22 22 22 22 62 62 62 62 62 62 62 62 62 62
