50 100
2 2 34 34 34 68 68 68 68 68 68 68 68 68 21 21 21 21 21 21 21 20 20 20 20 65 65 65 95 95 95 95 95 35 35 35 35 35 35 35 78 78 78 78 78 78 78 78 90 90
2 2 73 34 34 68 68 68 68 68 68 68 68 21 21 21 21 21 21 21 21 20 20 20 20 65 65 65 65 65 95 95 95 95 35 35 35 35 78 78 78 78 78 78 78 78 78 78 90 90
2 2 73 73 73 73 73 68 68 68 68 17 68 21 21 21 21 21 21 21 21 20 20 20 20 65 65 65 65 65 95 95 95 95 95 95 35 35 35 78 78 78 78 78 78 78 78 78 90 90
25 25 73 73 73 68 68 68 68 17 17 17 21 21 21 21 21 21 21 21 20 20 20 20 20 65 65 65 65 65 95 95 95 95 95 35 35 35 35 78 78 78 78 78 78 78 78 78 90 90
25 25 60 60 60 60 68 68 68 17 17 17 21 21 21 21 21 21 21 21 20 20 20 65 65 65 65 65 67 67 95 95 95 95 95 95 35 35 35 78 78 78 78 78 78 78 78 78 90 90
25 25 25 60 60 39 39 39 17 17 77 77 77 21 21 21 21 21 21 21 71 20 71 65 65 65 65 67 67 67 95 95 95 95 95 95 95 35 35 35 78 78 78 78 78 78 90 90 90 90
25 25 25 26 26 39 39 39 39 17 77 77 77 21 21 21 21 21 71 71 71 71 71 65 65 65 67 67 67 67 95 95 95 95 95 95 95 35 35 35 35 35 78 78 78 78 90 90 90 90
25 25 25 26 26 26 51 51 39 17 77 77 77 21 21 21 21 21 71 71 71 71 71 71 71 71 67 67 67 67 67 95 95 55 95 95 95 95 35 35 35 35 78 78 78 90 90 90 90 90
25 25 25 25 26 26 51 51 51 77 77 77 77 28 28 21 28 28 71 71 71 71 71 71 71 71 67 67 67 67 95 95 55 55 55 55 95 22 35 22 22 22 22 90 90 90 90 90 90 90
25 25 25 26 26 51 51 77 77 77 77 77 77 28 28 28 28 28 28 71 71 71 71 43 43 43 49 49 49 67 95 95 55 55 55 55 55 22 22 22 22 22 22 22 90 90 90 90 90 90
25 25 25 26 26 51 51 51 77 77 77 77 77 77 99 99 28 28 28 71 71 71 43 43 43 43 49 49 49 49 1 55 55 55 55 55 55 55 22 22 22 22 22 22 22 5 5 90 90 90
25 25 25 88 26 51 51 51 77 77 77 77 77 31 31 99 28 28 28 71 71 71 43 43 43 49 49 49 49 1 1 1 55 55 55 55 55 55 22 22 22 22 22 22 5 5 5 5 5 90
25 88 88 88 26 77 77 77 77 77 77 77 31 31 31 99 54 54 54 27 27 61 43 43 43 43 43 49 49 1 1 1 55 55 55 55 55 55 22 22 22 22 22 22 5 5 5 5 5 90
88 88 88 88 88 77 77 77 77 77 77 77 31 31 31 31 54 54 27 27 27 61 61 61 61 43 43 49 1 1 1 1 1 1 6 6 55 55 22 22 22 22 22 22 22 5 5 5 5 5
88 88 88 88 88 88 77 77 77 31 31 31 31 31 31 31 54 54 27 27 27 27 27 61 61 37 37 37 38 1 1 1 1 1 6 55 55 55 22 22 22 22 22 22 22 5 5 5 5 5
88 88 88 100 88 88 77 77 97 97 97 97 31 31 31 31 54 31 27 27 27 27 27 27 61 61 61 61 38 38 38 1 6 6 6 6 55 55 22 22 22 22 22 22 22 5 5 5 5 5
88 88 100 100 13 77 77 77 97 97 97 97 97 97 31 31 31 31 31 27 27 27 27 27 27 38 38 38 38 38 38 8 8 8 6 6 6 6 22 22 22 22 22 22 22 5 5 5 5 5
88 100 100 100 13 13 13 97 97 97 97 97 97 97 31 83 62 31 31 27 27 27 38 38 38 38 38 38 38 38 8 8 8 8 6 6 6 6 4 4 4 4 4 4 4 5 5 5 5 5
100 100 100 100 100 13 13 97 97 97 97 97 97 97 83 83 62 62 62 62 62 62 38 38 38 38 70 70 70 8 8 8 8 8 8 6 4 4 4 4 4 4 4 4 4 5 5 5 82 5
100 100 100 100 100 13 69 69 69 69 97 97 97 97 83 83 62 62 62 33 33 62 38 38 38 38 70 70 70 8 8 8 8 8 8 8 8 4 4 4 4 4 4 4 5 5 5 5 82 82
100 100 100 100 13 13 69 69 69 69 69 69 69 97 83 83 66 62 62 33 33 62 38 41 41 41 70 70 70 8 8 8 8 8 8 8 8 4 4 4 4 4 4 4 4 5 5 5 82 82
100 100 100 13 13 13 69 69 69 69 69 69 69 97 83 83 66 66 33 33 33 33 41 41 41 41 41 70 70 70 8 8 8 8 8 79 79 79 4 4 4 4 4 4 4 4 82 82 82 82
100 100 100 13 13 13 69 69 69 69 69 69 69 83 83 83 66 66 33 33 33 33 41 41 41 41 41 70 70 29 29 29 8 8 8 79 79 79 79 79 4 4 4 4 4 4 82 82 82 82
13 13 13 13 13 13 13 13 69 69 69 69 40 40 83 83 66 66 33 33 33 33 41 41 41 41 41 41 41 29 29 29 29 29 8 79 79 79 79 79 4 4 4 4 82 82 82 82 82 82
81 81 13 13 13 13 13 13 69 69 59 69 40 40 66 66 66 66 66 66 33 33 33 33 41 41 41 29 29 29 29 29 29 29 29 79 79 79 79 79 4 4 4 4 91 91 82 82 82 82
81 81 81 13 13 13 13 59 59 69 59 40 40 40 66 66 66 66 66 66 33 33 33 33 41 85 85 85 85 29 29 29 29 29 29 79 79 79 79 79 79 79 4 91 91 91 82 82 82 15
81 81 81 13 13 13 59 59 59 59 59 59 40 40 66 66 66 66 66 66 66 66 33 33 33 85 85 85 85 29 29 29 29 29 98 98 98 79 79 79 79 79 91 91 91 91 58 58 15 15
81 81 81 81 81 59 59 59 59 59 59 40 40 40 40 23 66 66 66 66 66 66 33 33 85 85 85 85 85 29 29 29 29 29 98 98 98 98 79 79 79 79 91 91 58 58 58 58 15 15
81 81 81 81 81 59 59 59 59 59 59 40 40 40 23 23 23 23 23 66 66 66 33 7 7 16 16 16 85 85 85 85 29 98 98 98 98 98 79 79 79 91 91 91 91 45 58 58 58 15
81 81 81 81 81 81 59 59 59 59 59 59 40 23 23 23 23 23 23 23 7 7 7 7 7 7 16 16 16 85 85 85 29 98 98 98 98 98 44 91 91 91 91 91 45 45 45 58 58 58
81 81 81 81 81 81 59 59 59 59 59 59 23 23 23 23 23 23 23 7 7 7 7 7 7 7 7 16 16 85 85 53 53 44 44 44 44 44 44 44 91 91 91 45 45 45 45 58 58 58
81 81 81 81 81 81 59 59 59 59 59 59 23 23 23 23 23 23 23 7 7 7 7 7 7 7 16 16 16 53 53 53 53 44 44 44 44 44 44 44 44 44 91 10 45 9 9 9 9 58
81 81 81 81 81 81 59 59 59 23 23 23 23 23 23 23 23 23 7 7 7 7 7 7 7 16 16 16 47 47 53 53 53 53 53 44 44 44 44 44 86 80 80 80 80 80 9 9 9 9
81 81 89 89 89 81 89 89 89 23 23 23 23 23 23 23 23 7 7 7 7 7 7 7 7 16 16 16 47 53 53 53 53 53 53 44 44 84 84 84 86 80 80 80 80 9 9 9 9 9
81 89 89 89 89 89 89 89 89 89 89 23 23 87 23 23 23 7 7 7 7 7 7 7 7 7 47 47 47 53 53 53 53 53 44 44 44 84 84 84 86 80 80 80 80 9 9 9 9 9
89 89 89 89 89 89 89 89 89 89 87 87 87 87 23 23 7 7 7 7 7 7 7 7 7 64 47 47 47 52 52 53 53 53 44 44 44 84 84 86 86 86 80 80 80 9 9 9 9 9
89 89 89 89 89 89 89 89 89 36 87 87 87 87 23 23 7 7 7 7 7 7 7 7 7 64 64 47 52 52 52 52 19 19 92 92 92 92 92 86 86 86 86 80 50 48 48 48 48 48
89 89 89 89 89 89 89 89 36 36 36 87 87 87 87 23 94 7 32 32 57 57 7 7 64 64 64 47 52 52 52 19 19 19 19 92 92 92 92 86 86 86 86 50 50 50 48 48 48 48
89 72 89 89 89 89 89 89 36 36 36 36 87 87 87 87 94 94 32 32 32 57 57 57 64 64 64 52 52 52 52 19 19 19 19 92 92 92 86 86 86 86 86 50 50 50 50 50 50 48
89 72 89 89 89 89 89 14 14 36 36 36 87 87 87 87 94 94 94 32 32 57 57 57 64 64 52 52 52 52 19 19 19 19 19 92 92 86 86 86 3 3 50 50 50 50 50 50 48 48
89 89 89 89 89 14 14 14 14 36 36 36 36 87 87 87 94 94 94 32 32 32 57 57 64 64 52 52 52 52 30 19 19 19 19 12 86 86 86 86 3 3 3 3 50 50 50 50 48 48
89 89 89 89 89 14 14 14 14 36 36 36 87 87 87 87 87 94 94 32 32 32 32 74 74 74 74 74 30 30 30 19 12 12 12 12 12 86 86 86 3 3 3 3 50 50 50 48 48 48
89 89 89 89 89 14 14 14 14 14 14 36 36 36 87 87 87 94 94 94 96 96 96 74 74 74 74 74 30 30 30 30 12 12 12 12 12 12 56 56 3 3 3 3 3 3 3 48 48 48
89 89 89 89 14 14 14 14 14 14 14 14 24 24 87 87 87 96 96 96 96 96 96 74 74 74 74 30 30 30 30 12 12 12 12 12 12 12 56 56 3 3 3 3 3 3 3 48 48 48
89 89 75 75 75 14 14 14 14 14 14 63 24 24 24 24 24 24 96 96 96 96 96 74 74 74 74 30 30 30 30 30 12 12 12 12 56 56 56 56 56 56 3 3 3 48 48 48 48 48
89 75 75 75 75 75 75 14 14 46 14 63 24 24 24 24 24 24 24 96 96 96 96 74 74 74 74 30 30 30 30 30 12 12 12 12 12 56 56 56 56 56 3 3 3 3 76 48 48 48
75 75 75 75 75 75 75 46 46 46 46 63 63 63 63 24 24 24 96 96 96 96 96 96 74 74 74 30 30 30 30 30 12 12 12 12 56 56 56 56 56 93 93 76 76 76 76 48 48 48
75 75 75 75 75 75 75 46 75 75 75 63 63 63 63 63 63 24 24 96 96 96 96 96 74 74 30 30 30 30 18 30 12 12 12 12 12 56 56 56 56 93 93 76 76 76 76 76 76 76
75 75 75 75 75 75 75 75 75 63 63 63 63 63 63 63 24 24 24 24 96 96 96 74 74 74 30 30 30 18 18 18 18 12 12 12 12 12 93 56 56 93 93 76 76 76 76 76 76 76
75 75 75 75 75 75 75 75 75 75 63 63 11 11 11 63 63 24 24 42 42 42 42 74 74 74 30 30 30 18 18 18 18 18 93 93 93 93 93 93 93 93 93 76 76 76 76 76 76 76
