66 65 65 24 0 24 13 0 0 0 13 7 7 0 0 7 7 49 0 49 49 97 0 0 0 0 97 99 0 99 99 87 0 0 87 19 19 19 64 64 64 39 39 88 0 0 0 0 0 0
66 65 24 24 0 24 13 0 0 13 13 13 7 0 0 7 49 49 0 49 84 97 97 97 97 97 97 99 0 99 19 87 87 87 87 19 19 39 39 39 39 39 39 88 0 0 0 0 0 0
66 44 44 24 0 24 13 13 13 13 72 7 7 0 0 7 7 49 49 49 84 97 97 84 84 97 97 99 99 99 19 19 19 19 19 19 19 19 19 39 39 39 88 88 0 0 88 88 88 88
44 44 44 24 0 24 24 73 73 13 72 72 7 0 7 7 7 49 49 84 84 84 84 84 84 97 97 34 34 19 19 19 19 19 19 19 19 19 57 39 39 39 39 88 0 88 88 59 59 59
44 44 44 24 24 24 73 73 73 13 72 72 7 7 7 49 49 49 49 84 84 84 84 84 84 84 97 34 34 19 19 19 19 19 19 19 19 57 57 57 39 39 39 88 88 88 59 59 0 0
3 3 3 24 24 3 73 73 73 73 72 72 72 49 49 49 49 49 49 84 84 84 84 84 84 84 97 34 34 19 19 19 19 19 19 57 57 57 57 57 57 39 39 100 100 100 59 59 59 0
0 0 3 3 3 3 73 73 73 73 73 72 72 89 89 89 89 89 49 84 84 84 84 84 84 84 34 34 34 34 34 19 19 57 57 57 57 57 57 57 57 100 100 100 100 100 100 100 59 59
0 0 0 0 0 3 73 73 73 73 73 72 72 89 89 89 89 89 89 84 84 84 84 84 84 34 34 34 34 34 34 57 57 57 57 57 57 57 57 57 57 100 100 100 100 100 100 100 100 59
3 3 3 3 3 3 73 73 73 73 73 72 72 89 89 89 89 89 89 89 89 84 84 84 84 34 34 34 34 34 34 57 57 57 57 57 57 57 57 57 57 100 100 100 100 100 100 100 100 59
32 32 32 3 3 73 73 73 73 73 72 72 4 4 89 89 89 89 67 89 67 67 84 84 84 34 34 34 34 34 34 57 46 94 94 94 94 57 57 54 54 54 100 100 100 100 100 100 100 59
0 0 32 3 3 73 73 73 4 4 4 4 4 4 4 89 89 89 67 67 67 67 34 34 34 34 34 92 34 92 92 46 46 94 94 94 94 54 54 54 54 54 100 100 100 100 100 100 100 100
0 0 32 32 32 73 73 4 4 4 4 4 4 4 26 26 26 67 67 67 67 67 34 36 36 34 34 92 92 92 98 46 46 46 94 94 94 94 54 54 54 54 54 54 100 100 100 16 16 16
0 0 0 0 32 32 32 4 4 4 4 4 26 26 26 26 26 67 67 67 67 36 36 36 36 36 92 92 92 92 98 98 46 46 46 94 54 54 54 54 54 18 18 54 54 100 100 16 0 0
0 0 0 0 0 0 32 4 4 4 4 4 26 26 38 38 67 67 67 6 67 6 36 36 36 36 92 92 92 92 92 98 98 98 94 94 94 94 54 18 18 18 18 54 100 100 100 16 0 0
32 32 32 32 32 32 32 22 22 63 63 63 63 38 38 11 11 11 11 6 6 6 36 36 36 36 36 92 92 92 92 98 98 98 94 94 94 94 54 18 18 18 18 18 16 16 16 16 0 0
32 33 32 32 76 76 32 22 69 69 69 63 63 38 38 11 11 11 74 11 6 6 36 36 36 36 36 36 92 92 92 92 92 37 94 94 94 25 18 18 18 25 18 18 16 0 0 0 0 0
33 33 33 32 76 76 76 22 22 22 69 69 69 11 11 11 11 11 11 11 6 36 36 36 36 75 36 36 92 92 92 92 37 37 37 37 37 25 25 25 25 25 25 25 16 0 0 0 0 0
0 0 33 33 76 76 76 22 22 22 69 69 69 11 11 11 11 11 11 11 6 36 36 36 75 75 75 92 92 92 92 92 37 37 37 37 37 37 25 25 25 25 25 25 16 16 16 0 0 0
0 0 0 33 31 31 76 22 22 22 22 69 28 11 11 11 11 11 11 11 11 61 75 75 75 75 75 92 92 92 92 92 37 37 37 37 37 25 25 25 25 25 45 25 25 45 16 16 16 16
33 33 33 33 31 31 31 31 22 22 22 28 28 60 60 60 60 11 11 11 61 61 61 61 75 75 75 75 92 92 92 92 37 37 37 37 37 25 25 25 25 45 45 45 45 45 45 50 50 50
93 93 93 31 31 31 31 31 31 28 28 28 28 60 60 60 60 11 11 61 61 61 61 61 75 75 75 71 71 79 79 79 37 37 17 17 17 25 25 25 45 45 45 45 45 50 50 50 0 0
93 93 93 31 31 31 31 31 28 28 28 28 60 60 60 60 60 11 91 61 61 61 61 61 75 75 71 71 71 71 79 79 79 17 17 17 25 25 25 25 45 45 45 45 45 45 50 0 0 0
93 48 48 31 31 31 31 31 28 28 28 28 60 60 60 60 60 91 91 61 61 61 61 61 61 71 71 71 71 71 79 79 79 79 17 17 25 25 25 25 45 45 45 45 45 45 50 0 0 0
93 48 48 31 31 31 31 31 28 28 28 60 60 60 60 60 60 91 91 91 91 91 61 61 71 71 71 71 79 79 79 79 79 79 17 17 17 25 25 14 45 45 45 45 45 45 50 0 0 0
93 48 48 31 31 31 31 31 31 28 28 60 60 60 60 60 60 91 91 91 91 61 61 61 71 71 71 71 71 79 79 79 79 40 40 40 14 14 14 14 45 45 45 45 45 50 50 0 0 0
93 48 48 31 31 31 31 31 31 28 28 60 60 1 91 91 91 91 91 91 91 91 61 61 71 71 71 71 71 79 77 40 40 40 40 40 14 14 14 14 45 45 45 45 45 50 0 0 0 0
93 48 48 48 48 48 31 31 31 28 28 28 28 1 1 1 1 1 1 1 91 61 61 61 71 71 71 71 77 77 77 77 40 40 40 40 14 14 14 14 45 45 45 45 45 50 50 0 50 50
93 48 0 0 0 48 48 31 31 28 28 28 28 78 1 1 1 1 1 1 78 78 78 71 71 71 71 77 77 77 77 77 40 40 40 14 14 14 14 14 45 45 45 45 85 85 50 0 50 15
93 48 0 0 0 0 48 31 28 28 28 78 78 78 1 1 1 1 1 78 78 78 78 78 71 71 71 53 53 53 77 40 40 40 40 40 58 14 14 14 14 14 45 45 85 50 50 0 50 15
48 48 0 0 0 0 48 78 78 78 78 78 78 78 78 1 1 1 78 78 78 78 78 78 71 71 71 53 53 53 53 53 40 40 40 40 58 14 14 14 14 14 14 85 85 85 50 50 50 15
0 0 0 0 48 48 48 78 78 78 78 78 78 78 78 78 78 78 78 78 78 78 78 78 53 53 53 53 53 53 53 53 53 40 40 58 58 14 14 14 14 14 14 43 85 85 15 15 15 15
0 0 0 0 48 78 78 78 78 78 78 78 78 78 78 78 78 78 78 78 78 78 78 78 53 53 53 53 70 70 70 70 53 41 40 40 58 14 14 14 14 14 43 43 15 15 15 15 0 0
48 48 48 48 48 78 78 78 78 78 78 78 12 12 12 12 12 12 12 12 78 78 78 78 78 78 53 70 70 70 70 70 41 41 40 40 58 14 14 30 14 43 43 43 43 20 20 15 15 15
8 8 5 5 5 5 5 78 78 78 78 12 12 12 12 12 12 12 12 12 42 78 78 78 78 78 70 70 70 70 41 41 41 41 41 40 30 30 14 30 30 43 43 43 20 20 20 20 20 20
8 8 8 5 5 5 5 5 78 78 12 12 12 12 12 12 12 12 12 42 42 78 78 78 78 78 29 29 29 29 41 41 41 41 41 40 30 30 30 30 43 43 43 43 20 0 0 0 0 0
8 8 8 5 5 5 5 5 5 5 5 12 12 12 12 12 12 12 12 42 42 78 78 78 82 82 29 29 29 29 41 41 41 30 30 30 30 30 30 30 43 43 43 43 20 0 0 0 0 0
8 8 8 8 8 21 5 5 5 5 5 12 12 12 12 12 12 12 12 12 42 82 82 82 82 82 82 29 29 29 41 41 41 30 30 30 30 30 30 30 43 43 43 83 20 20 20 0 0 0
8 8 8 8 8 21 5 5 5 5 5 5 5 5 5 5 12 12 12 12 12 82 82 82 82 82 82 29 29 29 29 41 30 30 30 30 30 30 30 30 83 83 83 83 20 62 20 20 20 0
8 8 8 8 8 21 21 21 21 5 5 5 5 5 5 5 5 5 5 5 12 82 82 82 82 82 82 82 82 29 29 29 29 30 30 30 30 30 30 30 83 83 83 83 83 62 62 62 20 20
8 8 8 8 8 21 21 21 21 5 5 5 5 5 5 5 5 5 5 5 5 82 82 82 82 82 82 82 82 82 29 29 29 30 30 30 30 30 9 9 9 83 83 83 83 62 0 62 62 62
8 8 8 8 21 21 21 21 21 21 21 5 5 52 23 23 23 5 51 51 51 82 82 51 51 51 82 82 82 82 29 82 95 95 30 30 30 30 9 9 9 83 83 83 62 62 0 0 0 0
8 8 8 8 8 21 21 21 21 21 21 52 52 52 23 23 23 51 51 51 51 51 51 51 51 82 82 82 82 82 82 82 95 95 95 90 90 90 9 80 83 83 83 83 62 62 62 62 62 62
8 8 8 8 8 8 8 8 8 52 52 52 52 52 23 23 23 51 51 51 51 51 51 51 51 82 82 82 82 82 82 95 95 95 90 90 90 90 80 80 80 83 83 83 83 62 55 55 55 62
8 8 8 8 8 8 8 8 8 52 52 52 52 52 52 23 23 23 23 51 51 51 51 51 51 82 51 82 82 82 95 95 95 95 95 90 90 90 80 80 80 80 80 80 80 55 55 0 55 62
8 8 8 8 8 8 8 8 8 52 52 52 52 52 52 23 86 86 86 86 51 51 51 51 51 51 51 82 82 82 95 95 95 95 95 90 90 2 2 2 80 80 80 80 80 55 0 0 55 55
8 8 8 8 8 8 8 8 8 8 52 52 52 52 52 52 86 86 86 68 51 51 51 51 56 51 51 82 82 82 81 95 81 95 95 90 90 2 2 2 80 80 80 80 55 55 0 0 0 0
35 35 35 8 8 8 8 8 8 8 8 27 52 52 52 52 68 86 86 68 68 51 51 51 56 56 96 96 96 81 81 81 81 81 81 90 90 2 2 2 2 80 80 80 55 55 55 0 0 0
35 35 35 35 35 35 8 8 8 8 27 27 27 27 27 27 68 68 68 68 68 56 56 56 56 96 96 96 96 81 0 0 0 81 90 90 81 81 2 2 2 80 10 10 10 10 55 55 0 0
35 35 35 35 35 8 8 8 8 8 27 0 0 0 0 27 68 68 0 0 68 56 0 56 96 96 0 96 81 81 81 81 0 81 81 81 81 81 2 2 10 10 10 0 0 10 10 55 0 0
47 35 35 35 35 35 8 8 8 8 27 0 0 0 0 27 27 68 0 0 68 56 0 56 96 0 0 96 96 96 96 81 0 0 0 0 0 81 2 2 10 0 0 0 0 0 10 55 0 0
66 65 65 24 0 24 13 0 0 0 13 7 7 0 0 7 7 49 0 49 49 97 0 0 0 0 97 99 0 99 99 87 0 0 87 19 19 19 64 64 64 39 39 88 0 0 0 0 0 0
66 65 24 24 0 24 13 0 0 13 13 13 7 0 0 7 49 49 0 49 84 97 97 97 97 97 97 99 0 99 19 87 87 87 87 19 19 39 39 39 39 39 39 88 0 0 0 0 0 0
66 44 44 24 0 24 13 13 13 13 72 7 7 0 0 7 7 49 49 49 84 97 97 84 84 97 97 99 99 99 19 19 19 19 19 19 19 19 19 39 39 39 88 88 0 0 88 88 88 88
44 44 44 24 0 24 24 73 73 13 72 72 7 0 7 7 7 49 49 84 84 84 84 84 84 97 97 34 34 19 19 19 19 19 19 19 19 19 57 39 39 39 39 88 0 88 88 59 59 59
44 44 44 24 24 24 73 73 73 13 72 72 7 7 7 49 49 49 49 84 84 84 84 84 84 84 97 34 34 19 19 19 19 19 19 19 19 57 57 57 39 39 39 88 88 88 59 59 0 0
3 3 3 24 24 3 73 73 73 73 72 72 72 49 49 49 49 49 49 84 84 84 84 84 84 84 97 34 34 19 19 19 19 19 19 57 57 57 57 57 57 39 39 100 100 100 59 59 59 0
0 0 3 3 3 3 73 73 73 73 73 72 72 89 89 89 89 89 49 84 84 84 84 84 84 84 34 34 34 34 34 19 19 57 57 57 57 57 57 57 57 100 100 100 100 100 100 100 59 59
0 0 0 0 0 3 73 73 73 73 73 72 72 89 89 89 89 89 89 84 84 84 84 84 84 34 34 34 34 34 34 57 57 57 57 57 57 57 57 57 57 100 100 100 100 100 100 100 100 59
3 3 3 3 3 3 73 73 73 73 73 72 72 89 89 89 89 89 89 89 89 84 84 84 84 34 34 34 34 34 34 57 57 57 57 57 57 57 57 57 57 100 100 100 100 100 100 100 100 59
32 32 32 3 3 73 73 73 73 73 72 72 4 4 89 89 89 89 67 89 67 67 84 84 84 34 34 34 34 34 34 57 46 94 94 94 94 57 57 54 54 54 100 100 100 100 100 100 100 59
0 0 32 3 3 73 73 73 4 4 4 4 4 4 4 89 89 89 67 67 67 67 34 34 34 34 34 92 34 92 92 46 46 94 94 94 94 54 54 54 54 54 100 100 100 100 100 100 100 100
0 0 32 32 32 73 73 4 4 4 4 4 4 4 26 26 26 67 67 67 67 67 34 36 36 34 34 92 92 92 98 46 46 46 94 94 94 94 54 54 54 54 54 54 100 100 100 16 16 16
0 0 0 0 32 32 32 4 4 4 4 4 26 26 26 26 26 67 67 67 67 36 36 36 36 36 92 92 92 92 98 98 46 46 46 94 54 54 54 54 54 18 18 54 54 100 100 16 0 0
0 0 0 0 0 0 32 4 4 4 4 4 26 26 38 38 67 67 67 6 67 6 36 36 36 36 92 92 92 92 92 98 98 98 94 94 94 94 54 18 18 18 18 54 100 100 100 16 0 0
32 32 32 32 32 32 32 22 22 63 63 63 63 38 38 11 11 11 11 6 6 6 36 36 36 36 36 92 92 92 92 98 98 98 94 94 94 94 54 18 18 18 18 18 16 16 16 16 0 0
32 33 32 32 76 76 32 22 69 69 69 63 63 38 38 11 11 11 74 11 6 6 36 36 36 36 36 36 92 92 92 92 92 37 94 94 94 25 18 18 18 25 18 18 16 0 0 0 0 0
33 33 33 32 76 76 76 22 22 22 69 69 69 11 11 11 11 11 11 11 6 36 36 36 36 75 36 36 92 92 92 92 37 37 37 37 37 25 25 25 25 25 25 25 16 0 0 0 0 0
0 0 33 33 76 76 76 22 22 22 69 69 69 11 11 11 11 11 11 11 6 36 36 36 75 75 75 92 92 92 92 92 37 37 37 37 37 37 25 25 25 25 25 25 16 16 16 0 0 0
0 0 0 33 31 31 76 22 22 22 22 69 28 11 11 11 11 11 11 11 11 61 75 75 75 75 75 92 92 92 92 92 37 37 37 37 37 25 25 25 25 25 45 25 25 45 16 16 16 16
33 33 33 33 31 31 31 31 22 22 22 28 28 60 60 60 60 11 11 11 61 61 61 61 75 75 75 75 92 92 92 92 37 37 37 37 37 25 25 25 25 45 45 45 45 45 45 50 50 50
93 93 93 31 31 31 31 31 31 28 28 28 28 60 60 60 60 11 11 61 61 61 61 61 75 75 75 71 71 79 79 79 37 37 17 17 17 25 25 25 45 45 45 45 45 50 50 50 0 0
93 93 93 31 31 31 31 31 28 28 28 28 60 60 60 60 60 11 91 61 61 61 61 61 75 75 71 71 71 71 79 79 79 17 17 17 25 25 25 25 45 45 45 45 45 45 50 0 0 0
93 48 48 31 31 31 31 31 28 28 28 28 60 60 60 60 60 91 91 61 61 61 61 61 61 71 71 71 71 71 79 79 79 79 17 17 25 25 25 25 45 45 45 45 45 45 50 0 0 0
93 48 48 31 31 31 31 31 28 28 28 60 60 60 60 60 60 91 91 91 91 91 61 61 71 71 71 71 79 79 79 79 79 79 17 17 17 25 25 14 45 45 45 45 45 45 50 0 0 0
93 48 48 31 31 31 31 31 31 28 28 60 60 60 60 60 60 91 91 91 91 61 61 61 71 71 71 71 71 79 79 79 79 40 40 40 14 14 14 14 45 45 45 45 45 50 50 0 0 0
93 48 48 31 31 31 31 31 31 28 28 60 60 1 91 91 91 91 91 91 91 91 61 61 71 71 71 71 71 79 77 40 40 40 40 40 14 14 14 14 45 45 45 45 45 50 0 0 0 0
93 48 48 48 48 48 31 31 31 28 28 28 28 1 1 1 1 1 1 1 91 61 61 61 71 71 71 71 77 77 77 77 40 40 40 40 14 14 14 14 45 45 45 45 45 50 50 0 50 50
93 48 0 0 0 48 48 31 31 28 28 28 28 78 1 1 1 1 1 1 78 78 78 71 71 71 71 77 77 77 77 77 40 40 40 14 14 14 14 14 45 45 45 45 85 85 50 0 50 15
93 48 0 0 0 0 48 31 28 28 28 78 78 78 1 1 1 1 1 78 78 78 78 78 71 71 71 53 53 53 77 40 40 40 40 40 58 14 14 14 14 14 45 45 85 50 50 0 50 15
48 48 0 0 0 0 48 78 78 78 78 78 78 78 78 1 1 1 78 78 78 78 78 78 71 71 71 53 53 53 53 53 40 40 40 40 58 14 14 14 14 14 14 85 85 85 50 50 50 15
0 0 0 0 48 48 48 78 78 78 78 78 78 78 78 78 78 78 78 78 78 78 78 78 53 53 53 53 53 53 53 53 53 40 40 58 58 14 14 14 14 14 14 43 85 85 15 15 15 15
0 0 0 0 48 78 78 78 78 78 78 78 78 78 78 78 78 78 78 78 78 78 78 78 53 53 53 53 70 70 70 70 53 41 40 40 58 14 14 14 14 14 43 43 15 15 15 15 0 0
48 48 48 48 48 78 78 78 78 78 78 78 12 12 12 12 12 12 12 12 78 78 78 78 78 78 53 70 70 70 70 70 41 41 40 40 58 14 14 30 14 43 43 43 43 20 20 15 15 15
8 8 5 5 5 5 5 78 78 78 78 12 12 12 12 12 12 12 12 12 42 78 78 78 78 78 70 70 70 70 41 41 41 41 41 40 30 30 14 30 30 43 43 43 20 20 20 20 20 20
8 8 8 5 5 5 5 5 78 78 12 12 12 12 12 12 12 12 12 42 42 78 78 78 78 78 29 29 29 29 41 41 41 41 41 40 30 30 30 30 43 43 43 43 20 0 0 0 0 0
8 8 8 5 5 5 5 5 5 5 5 12 12 12 12 12 12 12 12 42 42 78 78 78 82 82 29 29 29 29 41 41 41 30 30 30 30 30 30 30 43 43 43 43 20 0 0 0 0 0
8 8 8 8 8 21 5 5 5 5 5 12 12 12 12 12 12 12 12 12 42 82 82 82 82 82 82 29 29 29 41 41 41 30 30 30 30 30 30 30 43 43 43 83 20 20 20 0 0 0
8 8 8 8 8 21 5 5 5 5 5 5 5 5 5 5 12 12 12 12 12 82 82 82 82 82 82 29 29 29 29 41 30 30 30 30 30 30 30 30 83 83 83 83 20 62 20 20 20 0
8 8 8 8 8 21 21 21 21 5 5 5 5 5 5 5 5 5 5 5 12 82 82 82 82 82 82 82 82 29 29 29 29 30 30 30 30 30 30 30 83 83 83 83 83 62 62 62 20 20
8 8 8 8 8 21 21 21 21 5 5 5 5 5 5 5 5 5 5 5 5 82 82 82 82 82 82 82 82 82 29 29 29 30 30 30 30 30 9 9 9 83 83 83 83 62 0 62 62 62
8 8 8 8 21 21 21 21 21 21 21 5 5 52 23 23 23 5 51 51 51 82 82 51 51 51 82 82 82 82 29 82 95 95 30 30 30 30 9 9 9 83 83 83 62 62 0 0 0 0
8 8 8 8 8 21 21 21 21 21 21 52 52 52 23 23 23 51 51 51 51 51 51 51 51 82 82 82 82 82 82 82 95 95 95 90 90 90 9 80 83 83 83 83 62 62 62 62 62 62
8 8 8 8 8 8 8 8 8 52 52 52 52 52 23 23 23 51 51 51 51 51 51 51 51 82 82 82 82 82 82 95 95 95 90 90 90 90 80 80 80 83 83 83 83 62 55 55 55 62
8 8 8 8 8 8 8 8 8 52 52 52 52 52 52 23 23 23 23 51 51 51 51 51 51 82 51 82 82 82 95 95 95 95 95 90 90 90 80 80 80 80 80 80 80 55 55 0 55 62
8 8 8 8 8 8 8 8 8 52 52 52 52 52 52 23 86 86 86 86 51 51 51 51 51 51 51 82 82 82 95 95 95 95 95 90 90 2 2 2 80 80 80 80 80 55 0 0 55 55
8 8 8 8 8 8 8 8 8 8 52 52 52 52 52 52 86 86 86 68 51 51 51 51 56 51 51 82 82 82 81 95 81 95 95 90 90 2 2 2 80 80 80 80 55 55 0 0 0 0
35 35 35 8 8 8 8 8 8 8 8 27 52 52 52 52 68 86 86 68 68 51 51 51 56 56 96 96 96 81 81 81 81 81 81 90 90 2 2 2 2 80 80 80 55 55 55 0 0 0
35 35 35 35 35 35 8 8 8 8 27 27 27 27 27 27 68 68 68 68 68 56 56 56 56 96 96 96 96 81 0 0 0 81 90 90 81 81 2 2 2 80 10 10 10 10 55 55 0 0
35 35 35 35 35 8 8 8 8 8 27 0 0 0 0 27 68 68 0 0 68 56 0 56 96 96 0 96 81 81 81 81 0 81 81 81 81 81 2 2 10 10 10 0 0 10 10 55 0 0
47 35 35 35 35 35 8 8 8 8 27 0 0 0 0 27 27 68 0 0 68 56 0 56 96 0 0 96 96 96 96 81 0 0 0 0 0 81 2 2 10 0 0 0 0 0 10 55 0 0
