0 0 0 0 0 0 40 40 70 0 0 0 0 0 70 89 0 0 0 0 0 0 89 89 89 89 80 0 0 80 71 71 71 71 11 0 0 0 0 11 20 0 0 0 20 22 22 22 0 0
0 0 0 0 0 0 40 70 70 0 0 0 0 0 70 89 89 0 0 0 0 89 89 16 89 80 80 0 0 80 80 80 71 11 11 11 0 0 0 11 20 20 0 0 20 20 20 22 0 0
0 0 0 0 0 0 40 70 70 70 0 0 0 0 70 70 89 0 0 89 89 89 16 16 16 16 80 0 0 80 80 80 71 71 71 11 11 11 11 11 5 20 0 0 0 20 22 22 22 22
0 0 0 0 0 0 40 70 40 70 0 0 0 0 0 70 89 89 89 89 16 16 16 16 16 16 80 80 80 80 58 80 94 71 71 5 5 5 5 5 5 20 0 0 20 20 23 22 22 23
0 0 0 0 0 0 40 40 40 70 0 0 0 0 0 70 89 55 89 89 16 16 16 16 16 9 9 9 9 9 58 58 94 94 94 94 5 5 5 5 68 20 20 20 20 23 23 23 23 23
0 0 0 0 0 0 0 40 70 70 0 0 0 0 0 70 70 55 89 89 55 16 16 16 16 9 9 9 9 9 9 58 94 94 94 94 5 5 68 68 68 68 68 68 99 99 99 23 23 23
40 40 40 40 40 40 40 40 70 70 0 0 0 0 0 70 70 55 55 55 55 55 35 35 10 10 9 9 9 9 58 58 94 94 94 94 94 94 68 68 68 43 43 43 43 99 99 99 99 99
44 44 50 50 50 50 50 50 50 70 70 70 70 0 70 70 55 55 55 55 55 55 35 35 10 10 9 9 9 9 58 58 94 94 94 94 68 94 68 68 68 68 43 43 43 99 0 0 0 0
0 44 44 50 50 50 50 50 50 50 50 50 70 0 70 55 55 84 29 29 29 35 35 35 10 10 10 10 10 9 58 58 58 94 94 94 68 68 68 68 68 8 43 43 99 99 0 0 0 0
0 0 44 50 50 50 50 50 50 50 50 70 70 0 70 84 84 84 84 29 29 29 35 35 10 10 10 10 9 9 9 9 9 9 94 68 68 68 68 68 68 8 43 43 99 99 0 0 0 0
0 0 44 50 50 50 50 50 15 15 50 70 0 0 70 84 84 84 84 29 57 57 35 10 10 10 10 10 9 9 9 9 77 77 77 68 68 68 68 8 8 8 8 43 43 99 0 0 0 0
0 0 44 44 44 66 15 15 15 15 15 70 0 0 70 70 84 84 84 57 57 57 10 10 10 10 10 10 9 9 9 77 77 77 77 68 68 68 8 8 8 8 8 43 43 99 0 0 99 99
0 0 0 0 44 66 66 15 15 15 70 70 70 70 70 70 36 84 84 57 57 57 57 10 10 10 10 10 10 77 77 77 77 77 77 8 8 8 8 8 8 8 8 43 43 99 99 99 99 86
0 0 0 0 44 66 66 66 15 15 15 36 36 36 36 36 36 36 36 57 57 57 57 10 10 10 10 10 10 77 77 77 77 77 77 8 8 75 75 75 75 8 8 8 86 86 86 86 86 86
44 44 44 44 44 66 66 66 15 15 36 36 36 36 36 36 36 36 36 36 57 57 57 57 10 10 98 98 98 77 77 77 77 77 77 77 92 75 75 75 75 86 86 86 86 0 0 0 0 0
21 21 21 21 21 21 66 66 15 91 91 91 91 36 36 36 36 36 36 36 57 98 57 57 10 10 98 98 98 77 77 77 77 77 77 92 92 92 92 92 75 86 0 0 0 0 0 0 0 0
0 0 0 0 0 21 21 21 15 91 91 91 91 36 36 36 36 36 36 36 98 98 98 98 98 98 98 98 98 98 98 77 77 77 77 92 92 92 92 92 92 86 0 0 0 0 86 86 86 86
0 0 0 0 0 0 0 21 91 91 91 91 91 36 36 36 36 36 36 36 36 98 98 98 98 98 98 98 98 98 98 98 2 2 77 77 92 92 92 64 86 86 86 0 0 0 86 79 79 79
0 21 21 21 0 21 21 21 91 91 91 91 91 91 91 36 36 36 36 36 36 98 98 98 98 98 98 98 98 98 98 2 2 2 2 64 64 64 64 64 64 64 86 86 0 0 86 79 0 0
21 21 41 21 21 21 91 91 91 91 91 91 91 91 91 91 91 36 98 98 98 98 98 98 98 98 98 98 98 69 69 69 2 2 2 2 64 64 64 64 64 64 64 86 86 86 86 79 0 0
41 41 41 41 41 32 32 32 32 91 95 91 91 91 31 31 98 98 98 98 98 98 98 98 98 98 69 69 69 69 69 2 2 2 2 2 2 64 64 64 64 64 64 64 86 86 79 79 79 79
0 0 41 41 32 32 32 32 32 95 95 91 31 31 31 31 31 31 1 1 98 98 98 46 46 98 46 69 69 69 69 2 2 2 2 2 2 64 64 64 64 64 64 64 64 86 79 79 79 61
0 0 41 78 78 32 32 32 95 95 95 95 95 31 31 31 31 1 1 1 1 46 46 46 46 46 46 69 69 69 69 2 2 2 2 2 2 2 64 64 64 64 64 64 86 86 79 79 61 61
0 0 41 78 78 32 32 32 95 95 95 95 31 31 31 31 31 1 1 1 1 38 46 46 46 46 46 72 72 69 69 2 2 2 2 2 2 2 64 64 64 64 64 64 61 86 79 79 79 61
0 41 41 78 78 7 95 95 95 95 95 95 31 31 31 31 31 31 1 1 1 38 38 38 38 46 46 72 72 72 2 2 2 2 2 2 2 64 64 64 64 88 64 61 61 61 61 61 61 61
41 41 78 78 78 7 7 7 7 95 95 17 17 31 31 31 31 1 1 1 65 38 38 38 38 46 46 46 59 59 2 2 2 2 2 2 2 88 88 64 64 88 61 61 0 0 0 0 0 0
41 78 78 33 33 7 7 7 7 95 95 17 31 31 31 31 31 1 1 1 38 38 38 38 38 46 46 46 59 59 59 59 59 59 59 88 88 88 88 88 88 88 88 61 0 0 0 0 0 0
87 78 33 33 33 7 7 17 17 17 17 17 31 31 31 31 31 38 38 38 38 38 38 38 59 59 59 59 59 59 59 59 59 59 59 88 88 88 88 88 88 88 61 61 0 0 0 0 0 0
87 67 67 67 67 7 7 17 97 42 17 31 31 31 31 31 38 38 38 38 38 38 38 38 59 59 59 59 59 59 59 59 59 59 88 88 88 88 47 47 47 47 47 61 0 0 0 0 0 0
87 67 67 67 67 67 17 17 97 42 42 42 28 28 31 54 54 54 38 38 38 38 45 12 12 12 59 59 59 59 59 59 59 59 88 88 88 88 47 47 47 47 47 61 61 0 0 0 0 0
87 87 67 67 67 67 17 52 97 42 42 42 28 28 31 31 54 54 54 38 45 45 45 12 12 12 12 12 12 59 59 59 59 59 88 88 88 88 47 47 47 47 47 47 61 61 0 0 0 0
0 87 87 67 67 67 52 52 97 42 42 42 28 28 28 28 48 54 54 54 45 45 45 12 12 12 12 12 12 12 12 12 56 88 88 88 47 47 47 47 47 47 47 47 47 61 0 0 0 0
0 0 87 87 87 87 52 52 52 42 42 28 28 28 28 28 48 54 54 54 45 81 12 12 12 12 12 12 12 12 12 12 56 56 56 88 47 47 47 47 47 47 47 47 47 61 61 0 61 61
0 0 0 0 0 87 52 52 42 42 28 28 28 28 28 48 48 54 54 54 45 81 12 12 14 14 14 14 14 12 12 12 56 56 56 56 47 47 47 47 47 47 47 47 47 47 61 0 61 26
87 87 87 87 87 87 87 53 53 28 28 62 28 100 100 60 48 48 90 81 45 81 12 14 14 14 14 14 14 14 12 56 56 56 56 56 56 47 47 47 47 47 47 26 26 26 61 61 61 26
87 19 19 19 87 87 87 53 53 53 62 62 100 100 60 60 48 48 48 81 81 81 81 14 14 14 14 14 14 14 12 56 56 56 56 56 56 47 47 47 47 47 47 26 26 26 26 61 61 26
87 19 19 19 19 19 53 53 83 83 83 83 49 60 60 60 48 48 48 13 81 81 81 14 14 14 14 14 14 14 56 56 56 56 56 56 47 47 47 47 47 47 47 47 26 0 26 26 26 26
19 19 19 19 19 19 19 19 83 83 83 83 49 60 60 60 60 60 13 13 81 81 81 81 14 14 14 14 14 14 56 56 56 56 56 56 56 56 47 47 47 47 47 26 26 0 0 0 0 0
0 19 19 19 19 19 19 19 83 83 83 83 49 49 49 60 60 60 13 13 81 81 81 81 81 14 14 14 14 14 56 56 56 56 56 56 56 56 47 47 47 47 47 26 0 0 0 0 0 0
19 19 63 63 63 19 19 19 18 18 83 83 49 49 49 49 49 60 13 13 81 81 81 81 81 81 14 14 14 14 14 56 56 56 56 6 56 47 47 47 47 47 26 26 26 26 26 26 26 26
63 63 63 63 63 63 19 18 18 18 18 18 49 49 49 49 49 37 37 37 81 81 81 51 25 25 25 85 85 76 76 76 6 6 6 6 6 6 74 47 74 74 74 74 74 74 74 26 4 4
30 30 63 63 63 63 19 18 18 18 18 18 49 49 49 49 49 37 37 81 81 81 51 51 25 25 25 85 85 76 76 85 6 6 6 6 6 6 74 74 74 74 74 74 74 74 74 74 4 0
0 30 30 63 63 63 63 18 18 18 18 18 49 49 49 49 49 37 37 37 81 51 51 51 51 51 93 93 85 76 76 85 6 6 6 6 6 6 74 6 74 74 74 74 74 74 74 4 4 0
0 0 30 63 63 39 39 39 18 18 18 18 49 49 37 37 37 37 0 37 51 51 51 51 51 51 93 85 85 85 76 85 85 6 6 6 6 6 6 6 74 74 74 74 74 74 74 4 0 0
0 0 30 30 30 39 0 39 39 39 18 18 18 37 37 37 0 0 0 37 51 51 51 51 51 93 93 85 85 85 85 85 85 6 6 6 6 6 6 6 74 74 74 74 74 74 74 4 0 0
0 0 30 30 39 39 0 0 0 39 39 18 18 18 18 37 0 0 0 37 37 51 51 93 51 93 93 93 93 85 85 85 6 6 6 6 6 6 6 82 82 27 27 27 27 74 74 4 0 0
0 30 30 24 24 39 0 0 0 0 39 18 18 18 37 37 0 0 0 0 37 51 51 93 93 93 0 93 93 85 85 85 6 6 6 6 6 82 82 82 82 82 27 27 27 27 27 4 0 0
0 30 24 24 24 39 39 0 0 0 39 18 18 18 37 0 0 0 0 37 37 93 93 93 0 0 0 93 34 34 73 73 73 73 73 6 82 82 82 0 0 82 27 27 27 27 4 4 0 0
0 30 24 3 3 3 39 0 0 0 39 39 39 39 37 37 0 37 37 37 93 93 0 0 0 0 0 93 93 93 73 0 0 0 73 73 73 96 82 82 0 82 82 82 4 4 4 0 0 0
0 30 30 3 0 3 39 0 0 0 0 0 0 39 39 37 0 37 93 93 93 0 0 0 0 0 0 0 0 93 73 0 0 0 0 73 96 96 96 82 0 0 0 82 4 0 0 0 0 0
